1111111111111
1000000EP00C1
1111111111111







